ZZZZZZZZZZZZZZZZZZZZ
ZP.....Z......H...SZ
Z.ZZZ.Z.Z.ZZZZ.ZZZ.Z
Z.....Z.Z....Z...Z.Z
Z.ZZZZZ.ZZZZ.Z.Z.Z.Z
Z.......ZI...Z.Z.Z.Z
Z.ZZZZZZZ.ZZZZ.Z.Z.Z
Z...............Z..Z
Z.ZZZZZZZ.ZZZZZZZE.Z
Z.................ZZ
Z.ZZZZZZZZZZZZZZZ..Z
Z..F..............ZZ
Z.ZZZZZZZ.ZZZZZZZ..Z
Z.......H....G....ZZ
Z.ZZZZZZZ.ZZZZZZZ..Z
Z........I........ZZ
Z.ZZZZZZZZZZZZZZZ..Z
Z..................Z
ZZZZZZZZZZZZZZZZZZZZ
