####################
#P.....#......H...S#
#.###.#.#.####.###.#
#.....#.#....#...#.#
#.#####.####.#.#.#.#
#.......#K...#.#.#.#
#.#######.####.#.#.#
#...............#..#
#.#######.#######E.#
#.................##
#.###############..#
#..F..............##
#.#######.#######..#
#.......H....G....##
#.#######.#######..#
#........I........##
#.###############..#
#...........D......#
####################