####################
#P....#......H....S#
#.##.#.#.####.###..#
#....#.#....#...#..#
#.####.####.#.#.#..#
#......#K...#.#.#..#
#.######.####.#.#..#
#..............#...#
#.######.######.#E.#
#..............#...#
#.############.#.#.#
#..............#.#.#
#.######.#######.#.#
#..............#.#.#
#.######.######.#.##
#..............#...#
#.############.#.#.#
#.....H....D...#...#
####################