ZZZZZZZZZZZZZZZZZZZZ
ZP........Z...H...SZ
Z.ZZZ.Z.Z.ZZZZ.ZZZ.Z
Z.....Z.Z....Z...Z.Z
ZZZZZZZ.ZZZZ.Z.Z.Z.Z
Z...H...ZI...Z.Z.Z.Z
Z.ZZZZZZZZZZZZ.Z.Z.Z
Z............Z.HZ..Z
Z.ZZZZZZZ.ZZZZZZZE.Z
Z........G...Z....ZZ
ZZZZZZZZZZ...ZZZZ..Z
Z..F.......I......ZZ
Z.ZZZZZZZ.ZZZZZZZ..Z
Z.......H....G....ZZ
Z.ZZZZZZZ.ZZZZZZZ..Z
Z........I........ZZ
Z.ZZZZZZZZZZZZZZZZZZ
Z........HH.......CZ
ZZZZZZZZZZZZZZZZZZZZ
