####################
#P.....#......H...S#
#.###.#.#.####.###.#
#.....#.#....#...#.#
#.#####.####.#.#.#.#
#.......#I...#.#.#.#
#.#######.####.#.#.#
#...............#..#
#.#######.#######E.#
#.................##
#.###############..#
#..F..............##
#.#######.#######..#
#.......H....G....##
#.#######.#######..#
#........I........##
#.###############..#
#..................#
####################