########################
#P....#........#......S#
#.##.#.#.######.#.######
#....#.#......#.#......#
#.####.####.#.#.######.#
#......#K...#.#......#.#
#.######.####.######.#.#
#....H.........E.....#.#
#.######.######.######.#
#..............#......#
#.############.#.####.#
#......#.......#....#.#
#.####.#.##########.#.#
#......#....H....#..#.#
#.########.####.#.##.#.#
#......E....D...#....#.#
#.##############.####.#
#.....................#
########################