########################
#P....#.......#......S#
#.###.#.#####.#.#######
#.....#.....#.#.......#
#.#####.###.#.#######.#
#.....#...#.#.......#.#
#.###.###.#.#######.#.#
#...#.....#...H...#.#.#
#.#.#########.###.#.#.#
#.#.......#...#...#.#.#
#.#.#####.#.###.###.#.#
#.#.....#.#.....#...#.#
#.#####.#.#######.###.#
#...H...#...F.....#...#
#.#########.#####.#.#.#
#.......E...#.....#.#.#
#.#############.###.#.#
#.......G...........#.#
########################