ZZZZZZZZZZZZZZZZZZZZZZZZ
ZP....Z.......Z......SZ
Z.ZZZ.Z.ZZZZZ.Z.ZZZZZZZ
Z.....Z.....Z.Z.......Z
Z.ZZZZZ.ZZZ.Z.ZZZZZZZ.Z
Z.....Z...Z.Z.......Z.Z
Z.ZZZ.ZZZ.Z.ZZZZZZZ.Z.Z
Z...Z.....Z...H...Z.Z.Z
Z.Z.ZZZZZZZZZ.ZZZ.Z.Z.Z
Z.Z.......Z...Z...Z.Z.Z
Z.Z.ZZZZZ.Z.ZZZ.ZZZ.Z.Z
Z.Z.....Z.Z.....Z...Z.Z
Z.ZZZZZ.Z.ZZZZZZZ.ZZZ.Z
Z...H...Z...F.....Z...Z
Z.ZZZZZZZZZ.ZZZZZ.Z.Z.Z
Z.......E...Z.....Z.Z.Z
Z.ZZZZZZZZZZZZZ.ZZZ.Z.Z
Z.......G...........Z.Z
ZZZZZZZZZZZZZZZZZZZZZZZZ
