########################
#P....#.......#......S#
#.###.#.#####.#.#######
#.....#.....#.#.......#
#.#####.###.#.#######.#
#.....#...#.#.......#.#
#.###.###.#.#######.#.#
#...#.....#...H...#.#.#
#.#.#########.###.#.#.#
#.#.......#...#...#.#.#
#.#.#####.#.###.###.#.#
#.#.....#.#.....#...#.#
#.#####.#.#######.###.#
#...H...#...F.....#...#
#.#########.#####.#.#.#
#.......E...#K....#.#.#
#.#############.###.#.#
#.......G.....D.....#.#
########################