ZZZZZZZZZZ
ZP....,,,Z
Z,,,,,...Z
Z....K...Z
Z.....ZZZZ
Z....D,,,Z
ZZZZZZ,,,Z
ZZZZZZSSSZ
ZZZZZZZZZZ