ZZZZZZZZZZ
ZP....,,,Z
Z,,,,,.IEZ
Z....K.GFZ
Z..,..ZZZZ
Z.J..D,,,Z
ZZZZZZ,,,Z
ZZZZZZSSSZ
ZZZZZZZZZZ